2	2	2	2	2	2	2	2	2	2	2	2	2	2	2	2	2	2	2	2
2	0	0	2	2	0	0	0	2	2	0	0	0	0	0	2	2	0	0	2
2	0	0	2	2	0	2	0	0	2	0	2	2	2	0	2	0	0	0	2
2	2	0	2	0	0	2	2	0	2	0	2	2	2	0	2	0	2	2	2
2	0	0	2	0	2	2	2	0	0	0	2	2	2	0	2	0	2	2	2
2	0	2	2	0	2	2	2	2	2	2	2	0	0	0	2	0	0	2	2
2	0	2	2	0	0	0	0	0	2	2	2	0	2	2	2	2	0	2	2
2	0	2	2	2	2	2	2	0	2	2	2	0	2	2	2	0	0	2	2
2	0	0	0	0	0	2	2	0	2	2	0	0	2	0	0	0	2	2	2
2	2	2	2	0	2	2	2	0	2	2	0	2	2	0	2	2	2	0	2
2	2	2	2	0	0	0	0	0	2	2	0	2	2	0	0	0	2	0	2
2	0	0	0	0	2	2	2	0	2	2	0	2	2	2	2	0	0	0	2
2	0	2	2	2	2	2	2	0	2	2	0	2	2	0	0	0	2	0	2
2	0	0	0	0	0	2	2	0	2	2	0	2	2	0	2	2	0	0	2
2	2	2	0	2	2	2	2	0	0	2	0	0	0	0	2	2	0	0	2
2	2	2	2	2	2	2	2	2	2	2	2	2	2	2	2	2	0	0	2
2	2	2	2	2	2	2	2	2	2	2	2	2	2	2	2	2	2	2	2
3	14
16	2
18	15