2	2	2	2	2	2	2	2	2	2	2	2	2
2	0	0	2	2	0	0	0	2	2	0	0	2
2	2	0	2	2	0	2	0	0	2	0	0	2
2	2	0	2	0	0	2	2	0	2	0	2	2
2	0	0	2	0	2	2	0	0	0	0	0	2
2	0	2	2	0	2	0	2	2	2	2	0	2
2	0	0	0	0	0	0	0	0	2	0	0	2
2	0	2	2	0	2	2	2	0	0	0	0	2
2	2	2	2	2	2	2	2	2	2	2	2	2
8	5											
2	8											
10	7											
